0 2 2 2 0 2
1 1 1 1 1 1
1 3 0 3 3 1
1 3 3 3 3 1
1 1 1 1 1 1
4 4 0 4 0 1